11 24
@ @ @ @ @ @ @ @ @ @ @ @ @ @ @ @ @ @ @ @ @ @ @ @
@ . . @ @ @ @ . . . @ @ @ @ . . . @ @ @ @ . . @
@ . . . . . . . . . . . . . . . . . . . . . . @
@ . . @ @ @ @ . . . @ @ @ @ . . . @ @ @ @ . . @
@ . . . . . . . . . . . . . . . . . . . . . . @
@ . . @ @ @ @ . . . @ @ @ @ . . . @ @ @ @ . . @
@ . . . . . . . . . . . . . . . . . . . . . . @
@ . . @ @ @ @ . . . @ @ @ @ . . . @ @ @ @ . . @
@ . . . . . . . . . . . . . . . . . . . . . . @
@ . . @ @ @ @ . . . @ @ @ @ . . . @ @ @ @ . . @
@ @ @ @ @ @ @ @ @ @ @ @ @ @ @ @ @ @ @ @ @ @ @ @
10
1 1 9 22
2 1 1 22
1 2 9 21
2 2 1 21
2 3 8 21
3 1 2 21
7 2 5 21
6 2 8 22
8 5 8 20
6 6 1 1