11 24
@ @ @ @ @ @ @ @ @ @ @ @ @ @ @ @ @ @ @ @ @ @ @ @
@ . . @ @ @ @ . . . @ @ @ @ . . . @ @ @ @ . . @
@ . . . . . . . @ . . . . . . @ . . . . . . . @
@ . . @ @ @ @ . . . @ @ @ @ . . . @ @ @ @ . . @
@ . . . . . . . @ . . . . . . @ . . . . . . . @
@ . . @ @ @ @ . . . @ @ @ @ . . . @ @ @ @ . . @
@ . . . . . . . @ . . . . . . @ . . . . . . . @
@ . . @ @ @ @ . . . @ @ @ @ . . . @ @ @ @ . . @
@ . . . . . . . @ . . . . . . @ . . . . . . . @
@ . . @ @ @ @ . . . @ @ @ @ . . . @ @ @ @ . . @
@ @ @ @ @ @ @ @ @ @ @ @ @ @ @ @ @ @ @ @ @ @ @ @
2
1 1 9 20
9 1 1 20