11 24
@ @ @ @ @ @ @ @ @ @ @ @ @ @ @ @ @ @ @ @ @ @ @ @
@ . . @ @ @ @ . . . @ @ @ @ . . . @ @ @ @ . . @
@ . . . . . . . @ . . . . . . @ . . . . . . . @
@ . . @ @ @ @ . @ . @ @ @ @ . @ . @ @ @ @ . . @
@ . . . . . . . @ . . . . . . @ . . . . . . . @
@ . . @ @ @ @ . . . @ @ @ @ . . . @ @ @ @ . . @
@ . . . . . . . @ . . . . . . @ . . . . . . . @
@ . . @ @ @ @ . @ . @ @ @ @ . @ . @ @ @ @ . . @
@ . . . . . . . @ . . . . . . @ . . . . . . . @
@ . . @ @ @ @ . . . @ @ @ @ . . . @ @ @ @ . . @
@ @ @ @ @ @ @ @ @ @ @ @ @ @ @ @ @ @ @ @ @ @ @ @
2
1 1 9 22
9 1 1 22